#########################################
#A        # #   #           #   #     #
# ### ### # # ### # ####### # ### # ###
#   #   # # # #   #     #   #   # #   #
### ##### # # # ####### # ##### # ### #
#   #     # # #       # #   #       # #
# ### ##### ########### ### # ####### #
# #   #         #     #   # #       # #
# # ########### # ### # ### ####### # #
# #           # # #   #   #   #     # #
# ##### # ### # # # ####### # # ##### #
#     # # #   # # #       # # # #   # #
##### # # # ### # ####### # # # # ### #
#   # # # #   # #       # # # # #   # #
# # # # # ### # ##### # # # # # ### # #
# # # # #   # #     # # # # # #   # # #
# # # # ### # ##### # # # # # ### # # #
# # # #   # #     # # #   # #   # # # #
# # # ### # ##### # # ##### ### # # # #
# # #   # #   #   # #     #   # # # # #
# # ### # ### # ### ####### ### # # # #
# #   # #   # #   #       #   # # # # #
# ### # ### # ### # ##### # ### # # # #
#   # #   # #   # # #   # #   # # # # #
### # ### # ### # # # # # ### # # # # #
#   #     #   # # # # # #   # # #   # #
# ####### ### # # # # # ### # # ##### #
#       #   # # #   # #   # # #     # #
##### # ### # # ##### ### # # ####### #
#     # #   # #       #   # #       # #
# ##### # ### ######### ### ####### # #
# #     # #   #       #   #       # # #
# # ### # # ### ####### ### ##### # # #
# # #   # #   #       #   #   #   # # #
# # # ### ### # ##### ### ### # ### # #
# # #   #   # # #   #   #   # #   # # #
# # ##### ### # # # ##### ### # ### # #
# #     #   # # # #     #   # #   # # #
# ####### ### # # ####### ### ##### # #
#       #   #   #           #      B  #
#########################################